00000000000000000000
00000000000000000000
00000000000000000000
00000000000000000000
00000000000000000000
00000000000000000000
00000000000000000000
00000000000000000000
00000000000000000000
00000000000000000000
00000000000000000000
00000000000000000000
00000000111000000000
00000000111000000000
00000000111000000000
00000000000000000000
00010000100011001000
01010110110110011100
00000000000011001000
00000000000000000000